S,S,S,S,S,S,S,S,S,S,S,S,S,S,S,S,S,S,S
S,S,S,S,S,S,S,S,S,S,S,S,P,W,P,P,P,W,S
S,S,S,S,S,S,S,S,P,P,P,P,P,P,P,P,P,P,S
S,S,S,S,S,S,S,M,P,P,P,W,P,P,P,P,P,P,S
S,S,S,S,S,W,P,W,W,P,P,P,P,W,P,W,P,S,S
S,S,W,P,P,P,W,P,P,P,W,W,W,P,S,S,S,S,S
S,P,P,P,P,P,W,W,P,P,P,M,S,S,S,S,S,S,S
S,P,P,P,P,P,P,P,P,P,P,S,S,S,S,S,S,S,S
S,W,P,P,P,W,P,S,S,S,S,S,S,S,S,S,S,S,S
S,S,S,S,S,S,S,S,S,S,S,S,S,S,S,S,S,S,S
