_,_,_,_,_,_,_,_,_,_,_,_,f,_,_,_,_,_,_
_,_,_,_,_,_,_,_,_,_,_,_,_,_,_,i,_,m,_
_,_,C,_,_,_,_,_,_,_,_,_,_,_,_,_,_,_,_
_,_,_,B,_,_,_,_,_,_,_,_,t,_,a,_,d,_,_
_,_,_,_,_,_,_,_,_,_,_,_,_,_,_,_,_,_,_
_,_,_,_,_,_,_,_,_,_,_,_,_,_,_,_,_,_,_
_,_,D,_,A,_,T,_,_,_,_,_,_,_,_,b,_,_,_
_,_,_,_,_,_,_,_,_,_,_,_,_,_,_,_,c,_,_
_,M,_,I,_,_,_,_,_,_,_,_,_,_,_,_,_,_,_
_,_,_,_,_,_,F,_,_,_,_,_,_,_,_,_,_,_,_
