I,i,_,_,_,_,_,_,_,_,_,_,_,_,_,_,_,_,_
M,m,_,_,_,_,_,_,_,_,_,_,_,_,_,_,_,_,_
T,t,_,_,_,_,_,_,_,_,_,_,_,_,_,_,_,_,_
D,d,_,_,_,_,_,_,_,_,_,_,_,_,_,_,_,_,_
A,a,_,_,_,_,_,_,_,_,_,_,_,_,_,_,_,_,_
F,f,_,_,_,_,_,_,_,_,_,_,_,_,_,_,_,_,_
B,b,_,_,_,_,_,_,_,_,_,_,_,_,_,_,_,_,_
C,c,_,_,_,_,_,_,_,_,_,_,_,_,_,_,_,_,_
_,_,_,_,_,_,_,_,_,_,_,_,_,_,_,_,_,_,_
Y,_,_,_,_,_,_,_,_,_,_,_,_,_,_,_,_,_,_
